R 500 500

NO ./texture/north.xpm
SO ./texture/south.xpm
EA ./texture/east.xpm
WE ./texture/west.xpm

S ./texture/mononoke.xpm

C 135,206,250
F 54,25,42

11111111111111111111111111
10000000000000000000000001
10E000200000000000000000001
10000000000000000000000001
111111111111111111111111111
