R 1000 1000

NO ./texture/mononoke.xpm
SO ./texture/mononoke.xpm
WE ./texture/mononoke.xpm
EA ./texture/mononoke.xpm

S ./texture/mononoke.xpm

C 135,206,250
F 47,79,79

111111111111111111111111111111111111111111111111111111111111111111111111111111111111111111111111111111111111111111111111111111111111111111
100000000000000000000000000000000000000000000000000000000000000000000000000000000000000000000000000000000000000000000000000000000000000001
10N000002000000000000000000000000000000000000000000000000000000000000000000000000000000000000000000000000000000000000000000000000000000001
100000000000000000000000000000000000000000000000000000000000000000000000000000000000000000000000000000000000000000000000000000000000000001
111111111111111111111111111111111111111111111111111111111111111111111111111111111111111111111111111111111111111111111111111111111111111111

